250 0.1
000000000000
000000000000
000000000000
000000000000
000000000000
000000000000
000000000000
000000000000
000000000000
000000000000
000000000000
000000000000
000000000000
000000000000
000000000000
000000000000
000000000000
000000000000
000000000000
000000000000
000000000000
000000000000
000000000000
000000000000
000000000000
000001100000
000011110000
000000000000
000111111000
000011110000
000000000000
000110011000
011010010110
000010010000
000000000000
000000000000
000001100000
000001100000
000000000000
