100 0.3
000000000000000
000111000111000
000000000000000
010000101000010
010000101000010
010000101000010
000111000111000
000000000000000
000111000111000
010000101000010
010000101000010
010000101000010
000000000000000
000111000111000
000000000000000
