150 0.3
00000110001100101010
10101010101010101010
10101010101010101010
00101100110101010011
01011000000010101111
00000110001100101010
10101010101010101010
10101010101010101010
00101100110101010011
01011000000010101111
00000110001100101010
10101010101010101010
10101010101010101010
00101100110101010011
01011000000010101111
00000110001100101010
10101010101010101010
10101010101010101010
00101100110101010011
01011000000010101111
